{
    "map":[{
            "mapLevel": 1,
            "grid": [["■", "■", "■", "■", "■", "■", "■", "■", "■", "■", "■", "■", "■", "■", "■", "■"],
                    ["■", "□", "□", "□", "□", "□", "□", "□", "□", "□", "□", "□", "□", "□", "□", "■"],
                    ["■", "□", "□", "□", "□", "□", "□", "□", "□", "□", "□", "□", "□", "□", "□", "■"],
                    ["■", "□", "□", "□", "□", "□", "□", "□", "□", "□", "□", "□", "□", "□", "□", "■"],
                    ["■", "□", "□", "□", "□", "□", "□", "□", "□", "□", "□", "□", "□", "□", "□", "■"],
                    ["■", "□", "□", "□", "□", "□", "□", "□", "□", "□", "□", "□", "□", "□", "□", "■"],
                    ["■", "□", "□", "□", "□", "□", "□", "□", "□", "□", "□", "□", "□", "□", "□", "■"],
                    ["■", "□", "□", "□", "□", "□", "□", "□", "□", "□", "□", "□", "□", "□", "□", "■"],
                    ["■", "□", "◉", "□", "□", "□", "□", "□", "□", "□", "□", "□", "□", "□", "□", "■"],
                    ["■", "□", "□", "□", "□", "□", "□", "□", "□", "□", "□", "□", "□", "□", "□", "■"],
                    ["■", "■", "■", "■", "■", "■", "■", "■", "■", "■", "■", "■", "■", "■", "■", "■"]]
            }]
}